@@@@@@@@@@@@@@@@@@@
@...v....P.....a..@
@.@@@.@@@.@@@.@@@.@
@.@@@.@@@.@@@.@@@.@
@a@@@.@@@v@@@.@@@.@
@....F.......F....@
@.@@@.@@@.@@@.@@@.@
@.@@@.@@@.@@@.@@@.@
@a@@@.@@@a@@@.@@@.@
@...a.......a.....@
@.@@@.@@@.@@@.@@@.@
@.@@@.@@@.@@@.@@@.@
@a@@@.@@@v@@@.@@@.@
@....F.......F....@
@.@@@.@@@.@@@.@@@.@
@.@@@.@@@.@@@.@@@.@
@a@@@.@@@a@@@.@@@.@
@...a.......a.....@
@@@@@@@@@@@@@@@@@@@
