@@@@@@@@@@@@@
@..a..P.....@
@.@@@@.@@@@.@
@F@@@@.@@@@.@
@.@@@@.@@@@F@
@v....F.....@
@.@@@@.@@@@a@
@F@@@@.@@@@.@
@.@@@@.@@@@F@
@F.F..F..F..@
@@@@@@@@@@@@@
