@@@@@@@@@@@@@@@@@@@@
@..a...............@
@.@.@@@@@.@@@@@@.@.@
@.@.@@@@@.@@@@@@.@.@
@F@.@@@@@.@@@@@@.@.@
@.@.@@@@@F@@@@@@.@.@
@.@..............@.@
@.@@@@@@@.@@@@@@@@.@
@..a.........F.....@
@.@@@@@@@.@@@@@@@@.@
@F@..............@.@
@.@.@@@@@F@@@@@@.@.@
@.@.@@@@@.@@@@@@.@.@
@.@.@@@@@.@@@@@@.@F@
@.@.@@@@@.@@@@@@.@.@
@F.a..P..F.........@
@@@@@@@@@@@@@@@@@@@@